XXXXXXXXXXXX
XXOXOXXXOOOX
XOOOOXXOOXOX
XOOOXOOOOXOX
XXOXXOOXXXOX
XXOOOOOOOOOX
XXXXXXXXXXXX